{
    "tiles": [
        -1,  0,  1,  1,  1,  1,  0, 38, 
        38,  1, 38, 38,  2,  3,  1, 38, 
        38,  1, 38, 38, 10, 11,  1, 38, 
        38,  1, 38, 38, 38, 38,  1, 38, 
        38,  1, 38, 38, 38, 38,  1, 38, 
        40, 41, 42, 43, 44, 45, 46, 47,
        48, 49, 50, 51, 52, 53, 54, 55,
        56, 57, 58, 59, 60, 61, 62, 63
    ],
    "rotates": [
        -1,  -1, -1, -1, -1, -1, 90, -1,
        -1, 270, -1, -1, -1, -1, 90, -1,
        -1, 270, -1, -1, -1, -1, 90, -1,
        -1, 270, -1, -1, -1, -1, 90, -1,
        -1, 270, -1, -1, -1, -1, 90, -1,
        -1,  -1, -1, -1, -1, -1, -1, -1,
        -1,  -1, -1, -1, -1, -1, -1, -1,
        -1,  -1, -1, -1, -1, -1, -1, -1
    ]
}
